1111111111111111111111111111111111111111
1111111111111111111111111111111111111111
1111111111111111111111111111111111111111
1111111111111111111111111111111111111111
1111111111111111111111111111111111111111
1111111111111111111111111111111111111111
1111111111111111111111111111111111111111
1111111111111111100000111111111111111111
1111111111111110000030311111111111111111
1111111111111110830005001111111111111111
1111111111111110030052500111111111111111
1111111111111110000000000111111111111111
1111111111111110000100001111111111111111
1111111111111110001111111111111111111111
1111111111111111001111111111111111111111
1111111111111111111111111111111111111111
1111111111111111111111111111111111111111
1111111111111111111111111111111111111111
1111111111111111111111111111111111111111
1111111111111111111111111111111111111111
