1111111111111111111111111111111111111111
1111111111111111111111111111111111111111
1111111111111111111111111111111111111111
1111111111111111111111111111111111111111
1111111111111111111113111111111111111111
1111111111111111111111111111111111111111
1111111111111111000000000001111111111111
1111111111111111000000000001111111111111
1111111111111111000000000001111111111111
1111111111111111011111111101111111111111
1111111111111111010000000101111111111111
1111111111111111010000000101111111111111
1111111111111111010000000101111111111111
1111111111111111111111111111111111111111
1111111111111111110000000111111111111111
1111111111111111110000000111111111111111
1111111111111111110000000111111111111111
1111111111111111110002000111111111111111
1111111111111111111111111111111111111111
1111111111111111111111111111111111111111
