1111111111111111111113111111111111111111
1111111111111111111100011111111111111111
1111111111111111111001011111111111111111
1111111111111111111111110111111111111111
1111111111111111100001010011111111111111
1111111111111111110100111111111111111111
1111111111111111111111100001111111111111
1111111111111111111111110111011111111111
1111111111111111111000110001111111111111
1111111111111110000011111101010111111111
1111111111111110101010110111111111111111
1111111111111111110111110101011111111111
1111111111111111010100111111110111111111
1111111111111111110110101101011111111111
1111111111111101011011111111010111111111
1111111111111101001010101001010111111111
1111111111111101111011101101110011111111
1111111111111111101110111111001011111111
1111111111111100100100100001101011111111
1111111111111111111112111111111111111111
