1111111111111111111113111111111111111111
1111111111110000001100000010100101000001
1111111111110100101011101010111001111111
1111111111111111100111111101011101001011
1111111111110010110100000010101011111111
1111111111110111110101111101110101011001
1111111111111110010101011110111011101111
1111111111110011110100010000100000100011
1111111111110001101111011111011111010111
1111111111110111111111010111011101111011
1111111111110101001011111000100110011001
1111111111111100011100001010110101011111
1111111111111111110110101010110101110101
1111111111110110111010101010110100010111
1111111111110110001111101010110111111101
1111111111111111010010101010110001000111
1111111111110111111010101111101010111101
1111111111110000001010101010010110110001
1111111111111111111110111011111111111111
1111111111111111111112111111111111111111
