1111111111111111111003011111111111111113
1311110010000111111050010011111010010105
1511110111110111111113111111111011111110
1011110111100110010531111011111111111111
1111111111111110111111111001010011111110
1011110011110111111111111111111110001000
1111111010010110001001001010010111111111
1011111111111110111101111111111110111111
1001001010111111111111011111111010111111
1111001000111001001100000100011010001000
1111111111111011111111111111011111111111
1001011011111111111101111111111311111110
1111001010011011001001010011011511101110
1111111111001001011111110111001000100110
1111110111011111011101111110011011111111
1001000111111101001111111111111110010010
1011110111001001100101001011111110111010
1111111111011111121111101001010011111111
1011110111111100111101111111111110111011
1053110010010001111001100101000100111000
